000000000000000000000000000000000000000000000000000000000000000000000000000000000000
000000000000000000000000000000000000000000000000000000000000000000000000000000000000
000000000000000000000000000000000000000000000000000000000000000000000000000000000000
000000000000000000000000000000000000000000000000000000000000000000000000000000000000
000000000000000000000000000000000000000000000000000000000000000000000000000000000000
000000000000111111111111111110000000000000000000000000000000000000000000000000000000
000000000001112222222222222111110000000000000000000000000000000000000000000000000000
000000000011122222222222222211111000000000000000000000000000000000000000000000000000
000000000111222222222222222222211110000000000000000000000000000000000000000000000000
000000001112222222222222222222222111110000000000000000000000000000000000000000000000
000000011122222222222222222222222221111000000000000000000000000000000000000000000000
000000111222222222222222222222222222211110000000000000000000000000000000000000000000
000001112222222222222222222222222222222111110000000000000000000000000000000000000000
000001122222222222222222222222222222222221111000000000000000000000000000000000000000
000001222222222211111112222222222222222222211111000000000000000000000000000000000000
000001222222222110000011112222222222222222222111110000000000000000000000000000000000
000001222222221110000001111222222222222222222221111000000000000000000000000000000000
000001222222221000000000011111222222222222222222211110000000000000000000000000000000
000001222222221000000000000011112222222222222222222111110000000000000000000000000000
000001222222221000000000000001111222222222222222222221111100000000000000000000000000
000001222222221000000000000000001111222222222222222222211111000000000000000000000000
000001222222221000000000000000000011112222222222222222222111110000000000000000000000
000001222222221000000000000000000001111222222222222222222221111000000000000000000000
000001222222221000000000000000000000011111222222222222222222211111000000000000000000
000001222222221000000000000000000000000011112222222222222222222111110000000000000000
000001222222221000000000000000000000000011111222222222222222222211111000000000000000
000001222222221000000000000000000000000000001111222222222222222222211110000000000000
000001222222221000000000000000000000000000000011112222222222222222222111110000000000
000001222222221000000000000000000000000000000001111222222222222222222211111000000000
000001222222221000000000000000000000000000000000001111222222222222222222211110000000
000001222222221000000000000000000000000000000000000011112222222222222222222111000000
000001222222221000000000000000000000000000000000000001111222222222222222222211100000
000001222222221000000000000000000000000000000000000000001111222222222222222221110000
000001222222221000000000000000000000000000000000000000000011111222222222222222110000
000001222222221000000000000000000000000000000000000000000001111112222222222222110000
000001222222221000000000000000000000000000000000000000000000000111122222222222110000
000001222222221000000000000000000000000000000000000000000000000000111222222222110000
000001222222221000000000000000000000000000000000000000000000000000111222222222110000
000001222222221000000000000000000000000000000000000000000000000000001112222222110000
000001222222221000000000000000000000000000000000000000000000000000000112222222110000
000001222222221000000000000000000000000000000000000000000000000000000112222222110000
000001222222221000000000000000000000000000000000000000000000000000000112222222110000
000001222222221000000000000000000000000000000000000000000000000000000112222222110000
000001222222221000000000000000000000000000000000000000000000000000000112222222110000
000001222222221000000000000000000011111111111111000000000000000000000112222222110000
000001222222221000000000000000001111222222222221110000000000000000000113333333110000
000001222222221000000000000000111112222222222221110000000000000000000113333333110000
000001222222221000000000000011112222222222222222111000000000000000000112222222110000
000001222222221000000000001111222222222222222222221110000000000000000112222222110000
000001222222221000000000111112222222222222222222221110000000000000000112222222110000
000001222222221000000111111222222222222222222222222110000000000000000112222222110000
000001222222221000001111222222222222222222222222222211000000000000000112222222110000
000001222222221000111112222222222222222222222222222211000000000000000112222222110000
000001222222221001111222222222222222222211222222222221000000000000000112222222110000
000001222222221111222222222222222222222111122222222221110000000000000112222222110000
000001222222222111222222222222222222221111112222222222110000000000000112222222110000
000001222222222222222222222222222222211000111222222222110000000000000112222222110000
000001222222222222222222222222222211110000001222222222211000000000000112222222110000
000001222222222222222222222222222111110000001222222222211000000000000112222222110000
000001222222222222222222222222211110000000001122222222221100000000000112222222110000
000001222222222222222222222211110000000000000112222222221110000000000112222222110000
000001222222222222222222222111110000000000000112222222221110000000000112222222110000
000001122222222222222222211110000000000000000111222222222110000000000112222222110000
000000111222222222222111110000000000000000000001222222222111000000000112222222110000
000000111222222222221111110000000000000000000001222222222211000000000112222222110000
000000001111111111111000000000000000000000000001122222222221000000000112222222110000
000000000000000000000000000000000000000000000000112222222221110000001112222222110000
000000000000000000000000000000000000000000000000112222222222110000011122222222110000
000000000000000000000000000000000000000000000000111222222222211111111222222222110000
000000000000000000000000000000000000000000000000001222222222222222222222222222110000
000000000000000000000000000000000000000000000000001222222222222222222222222222110000
000000000000000000000000000000000000000000000000001122222222222222222222222222110000
000000000000000000000000000000000000000000000000000112222222222222222222222222110000
000000000000000000000000000000000000000000000000000112222222222222222222222222110000
000000000000000000000000000000000000000000000000000111222222222222222222222221100000
000000000000000000000000000000000000000000000000000001122222222222222222222111000000
000000000000000000000000000000000000000000000000000001112222222222222222222110000000
000000000000000000000000000000000000000000000000000000111112222222222222221100000000
000000000000000000000000000000000000000000000000000000000011111111111111110000000000
000000000000000000000000000000000000000000000000000000000001111111111111000000000000
000000000000000000000000000000000000000000000000000000000000000000000000000000000000
000000000000000000000000000000000000000000000000000000000000000000000000000000000000
000000000000000000000000000000000000000000000000000000000000000000000000000000000000
000000000000000000000000000000000000000000000000000000000000000000000000000000000000
